WWWWWWWWWWWWWWWWWWWWWWWWWWWWWWWWWWWWWWWWWWWWWWWWWWWWWWWWWWWWWWWWWWWWWWWWWWWWWWWW
WPPPPPPPPPPPPPPWWWWWWWWWWWWWWWWWWWWWWWWWWWWWWWWWWWWWWWWWWWWWWWWWWPPPPPPPPPPPPPPW
WPPPPPPPPPPPPPPWWWWWWWWWWWWWWWWWWWWWWWWWWWWWWWWWWWWWWWWWWWWWWWWWWPPPPPPPPPPPPPPW
WPPPPPPPPPPPPPPPPPPPPPPPPPPPPPPPPPPPPPPPPPPPPPPPPPPPPPPPPPPPPPPPPPPPPPPPPPPPPPPW
WPPPPPPPPPPPPPPPPPPPPPPPPPPPPPPPPPPPPPPPPPPPPWWWWPPPPPPPPPPPPPPPPPPPPPWWWPPPPPPW
WPPPPPPPPPPPPPPPPPPPPPPPPPPPPPPPPPPPPPPPPPPPPPPWWPPPPPPPPPPPPPPPPPPPPPPPPPPPPPPW
WPPPPPPPPPPPPPPPPPPPPPPPPPPPPPPPPPPPPPPPPPPPPPPPWPPPPPPPPPPPPPPPPPPPPPPPPPPPPPPW
WPPPPPPPPPPPPPPPPPWWWWWWWWPPPPPPPPPPPPPPPPPPPPPPWPPWWWWWPPPPPPPPPPPPPPPPPPPPPPPW
WPPPPPWWPPPPPPPPPPPPPPPPPPPPPPPPPPPPPPPPPPPPPPPWPPPPPPPPPPPPPPPPPPPPPPPPPPPPPPPW
WPPPPPPPWPPPPPPPPPPPPPPPPPPPPPPPPPPPPPPPPPPPPPPPPPPPPPPPPPPPPPPPPPWWWWPPPPPPPPPW
WPPPPPPPWPPPPPPPPPPPPPPPWWWWPPPPPPPPPPWWPPPPPPPPPPPPPPPPPPPPPPPPPPPPWPPPPPPPPPPW
WPPPPPWWWWPPPPPPPPPPPPPPPPPPPPPPPPPPPPPPPPPPPPPPPPPPPPPPPPPPPPPPPPPPWPPPPPPPPPPW
WPPPPPPWWPPPPPPPPPPPPPPPPPPPPPPPPPPPPPPPPPPPPPPPPPPPPPPPPPPPPPPPPPPWWWPPPPPPPPPW
WPPPPPPWPPPPPPPPPPPPPPPPPPPPPPPPPPPPPPPPPPPPPPPPPPPPPPPPPPPPPPPPPPPPPPPPPPPPPPPW
WPPPPPPWPPPPPPPPPPPPPWWWPPPPPPPPPPPPPPPPPPPPPWWWWWWPPPPPPPPPPPPPPPPPPPPPPPPPPPPW
WPPPPPPPPPPPPPPPPPPPPPPPPPPPPPPPPPPPPPPPPPPPPPPWPPPPPPPPPPPPPPPPPPPPPPPPPPPPPPPW
WPPPPPPPPPPPPPPPPPPPPPPPPPPPPPPPPPPPPPPPPPPPPPPWPPPPPPPPPPPPPPPPPPPPPPPPPPPPPPPW
WPPPPPWWWPPPPPPPPPPPPPPPPPPPPPPPPPPPPPPPPPPPPPPWWWPPPPPPPPPPPPPPPPPPPPPPPPPPPPPW
WPPPWWPPPWWWWWPPPPPPPPPPPPPPPPPPPPPPPPPPPWWPPPPPPPPPPPPPPPPPPPPPPPPPPPPPPPPPPPPW
WPPPPPPPPPPPPPPPPPPPPPPPPPPPPPPPPPPPPPPPPPPPPPPPPPPPPPPPPPPPPPPPPPWWWWPPPPPPPPPW
WPPPPPPPPPPPPPPPPPPPPPPPPPPPPPPPPPPPPPPPPPPPPPPPPPPPPPPPPPPPPPPPPPWPPPPPPPPPPPPW
WPPPPPPPPPPPPPPPPWPPPPPPPPPPPPPPPPPPPPPPPPPPPPPPPPPPPPPPPPPPPPPPPPWPPPPPPPPPPPPW
WPPPPPPPPPPPPPPPPWPPPPPPPPPPPPPPPPPPPPPPPPPPPPPPPPPPPPPPPPPPPPPPPPWWWWPPPPPPPPPW
WPPPPPPPPPPPPPPPPWPPPPPPPPPPPPPPPPPPPPPPPPPPPPPWWWWWWPPPPPPPPPPPPPPPPPPPPPPPPPPW
WPPPPPPPPPPPPPPWWWWWPPPPPPPPPPPPPPPPPPPPPPPPPPPPPPPPPPPPPPPPPPPPPPPPPPPPPPPPPPPW
WPPPPPPPPPPPPPPPPPPPPPPPPPPPPPPPPPPPPPPPPPPPPPPPPPPPPPPPPPPPPPPPPPPPPPPPPPPPPPPW
WPPPPPPPPPPPPPPPPPPPPPPPPPPPPPPPPPPPPPPPPPPPPPPPPPPPPPPPPPPPPPPPPPPPPPPPPPPPPPPW
WPPPPPPPPPPPPPPPPPPPPPPPPPPPPPPPPPPPPPPPPPPPPPPPPPPPPPPPPPPPPPPPPPPPPPPPPPPPPPPW
WPPPPPPPPPPPPPPPPPPPPPPPPPPPPPPPPPPPPPPPPPPPPPPPPPPPPPPPPPPPPPPPPPPPPPPPPPPPPPPW
WPPPPPPPPPPWPPPPPPPPPPPPPPPPPPPPPPPPPPPPPPPPPPPPPPPPPPPPPPPPPPPPPPPPPPPPPPPPPPPW
WPPPPPPPPPPWPPPPPPPPPPPPPPPPPPPPPPPPPPPPPPPPPPPPPPPPPPPPPPPPPPPPPPPPPPPPPPPPPPPW
WPPPPPPPPPPWWPPPPPPPPPPPPPPPPPPPPPPPPPPPPPPPPPPPPWWWWPPPPPPPPPPPPPPPPPPPPPPPPPPW
WPPPPPPPPPWWWWWPPPPPPPPPPPPPPPPPPPPPPPPPPPPPPPPPPPPPPPPPPPPPPPPPPPPPPPPPPPPPPPPW
WPPPPPPPPPPPPPPPPPPPPPPPPPPPPPPPPPPPPPPPPPPPPPPPPPPPPPPPPPPPPPPPPPPPPPPPPPPPPPPW
WPPPPPPPPPPPPPPPPPPPPPPPPPPPPPPPPPPPWWWWWPPPPPPPPPPPPPPPPPPPPPPPPPPPPPPPPPPPPPPW
WPPPPPPPPPPPPPPPPPPPPPPPPPPPPPPPPPPPPPPPPPPPPPPPPPPPPPPPPPPPPPPPPPWWPPPPPPPPPPPW
WPPPPPPPPPPPPWWWWWWPPPPPPPPPPPPPPPPPPPPPPPPPPPPPPPPPPPPPPPPPPPPPPPPPPPPPPPPPPPPW
WPPPPPPPPPPPPPPWPPPPPPPPPPPPPPPPPPPPPPPPPPPPPPPPPPPPPPPPPPPPPPPPPPPPPPPPPPPPPPPW
WPPPPPPPPPPPPPPWPPPPPPPPPPPPPPPPPPPPPPPPPPPPPPPPPPPPPPPPPPPPPPPPPPPPPPPPPPPPPPPW
WPPPPPPPPPPWWWWWPPPPPPPPPPPPPPPPPPPPPPPWWWWWWPPPPPPPPPPPPPPPPPPPPPPPPPPPPPPPPPPW
WPPPPPPPPPPPPPPPPPPPPPPPPPPPPPPPPPPPPPPPWWWPPPPPPPPPPPPPPPPPPPPPPPPPPPPPPPPPPPPW
WPPPPPPPPPPPPPPPPPPPPPWWWWPPPPPPPPPPPPPPWWWPPPPPPPPPPPPPPPPPPPPPPPPPPPPPPPPPPPPW
WPPPPPPPPPPPPPPPPPPPPPPPPPPPPPPPPPPPPPPPPPPPPPPPPPPPPPPPPPPPPPPPPPPPPPPPPPPPPPPW
WPPPPPPPPPPPPPPPPPPPPPPPPPPPPPPPPPPPPPPPPPPPPPPPPPPPPPPPPPPPPPPPPPPPPPPPPPPPPPPW
WWWWWWWWWWWWWWWWWWWWWWWWWWWWWWWWWWWWWWWWWWWWWWWWWWWWWWWWWWWWWWWWWWWWWWWWWWWWWWWW